NO ./assets/grass2.xpm
SO ./path_to_the_south_texture
WE         ./path_to_the_west_texture

EA    ./path_to_the_east_texture

F       250,100,0
C      225,30,0

111111111111111111111111111
101101000001111010000100001
101101011101111010110101101
100001011101111010000100001
101101000001110110110100111
10110101110100111011N101001
111111111111111111111111111