NO ../assets/stone.xpm
SO ../assets/lava.xpm
WE ../assets/earth.xpm
EA ../assets/ice.xpm

F 160,160,160



C 153,204,255

111111111111111111111111111111111111
100000000000000000000000000000000011
100000000000000000000000000000000011
100010001111111111110000000000000011
100010000011       10000000000010001
100011011001       10000000000010001
100000000001       10000000000010001
100011110001       10000000000010001
10001  10001       10000000000010001
100011110001111111111000000000001001
100S00000000000000000000000000000001
111111111111111111111111111111111111